40
30
WWWWWWWWWWWWWWWWWWWWWWWWWWWWWWWWWWWWWWWW
WWWWWWWWWWWWWWW           WWWWWWWWWWWWWW
WWWWWWWWWWWWWWW           WWWWWWWWWWWWWW
WWWWWWWWWWWWWWW           WWWWWWWWWWWWWW
WWWWWWW                   WWWWWWWWWWWWWW
WWWWWWW PPPPPP WWWWWWWWW  WWWWWWWWWWWWWW
WWWWWWW                   WWWWWWWWWWWWWW
WWWWWWW PPPPPPPPPPPPPPPP  WWWWWWWWWWWWWW
WWWWWWW                   WWWWWWWWWWWWWW
WWWWWWW PPPPPPPPPPPPPPPP  WWWWWWWWWWWWWW
WWWWWWW                   WWWWWWWWWWWWWW
WWWWWWW PPPPP  PP  PPPPP  WWWWWWWWWWWWWW
WWWWWWW                   WWWWWWWWWWWWWW
WWWWWWW PPPPPPPPPPPPPPPP  WWWWWWWWWWWWWW
WWWWWWW                   WWWWWWWWWWWWWW
WWWWWWW PPPPPPPPPPPPPPPP  WWWWWWWWWWWWWW
WWWWWWW                   WWWWWWWWWWWWWW
WWWWWWW                                W
WWWWWWWWWWWWW   WWWWWWW  PPPPPPPPPPPPP W
WWWWWWWWWWWW     WWWWWW                W
WWWWWWWWWWWW     WWWWWW  PPPPPPPPPPPPP W
WWWWWWWWWWWW S   WWWWWW                W
WWWWWWWWWW       W       PPPPPPPPPPPPP W
WWWWWWWWWW                             W
WWWWWWWWWWWWWWWWWW  PPPPP  PPPPPP  PPP W
WWWWWWWWWWWWWWWWWW                     W
WWWWWWWWWWWWWWWWWW  PPPPPPPPPPPPPPPPPP W
WWWWWWWWWWWWWWWWWW                     W
WWWWWWWWWWWWWWWWWW  PPPPPPPPPPPPPPPPPP W
WWWWWWWWWWWWWWWWWW                     W
WWWWWWWWWWWWWWWWWWWWWWWWWWWWWWWWWWWWWWWW
