40
30
WWWWWWWWWWWWWWWWWWWWWWWWWWWWWWWWWWWWWWWW
W                  S                   W
WPPPPPPPPPPPPPP         PPPPPPPPPPPPPPPW
WPPPPPPPPPPPPPP         PPPPPPPPPPPPPPPW
W                                      W
W                                      W
WPPPPPPPPPPPPPP         PPPPPPPPPPPPPPPW
WPPPPPPPPPPPPPP         PPPPPPPPPPPPPPPW
W                                      W
W  E                                   W
WPPPPPPPPPPPPPP         PPPPPPPPPPPPPPPW
WPPPPPPPPPPPPPP         PPPPPPPPPPPPPPPW
W                                      W
W                              E       W
WPPPPPPPPPPPPPP         PPPPPPPPPPPPPPPW
WPPPPPPPPPPPPPP         PPPPPPPPPPPPPPPW
W                                      W
W   E                                  W
WPPPPPPPPPPPPPP         PPPPPPPPPPPPPPPW
WPPPPPPPPPPPPPP         PPPPPPPPPPPPPPPW
W                                      W
W                             E        W
WPPPPPPPPPPPPPP         PPPPPPPPPPPPPPPW
WPPPPPPPPPPPPPP         PPPPPPPPPPPPPPPW
W                                      W
W   E                                  W
WPPPPPPPPPPPPPP         PPPPPPPPPPPPPPPW
W                                      W
WWWWWWWWWWWWWWWWWWWWWWWWWWWWWWWWWWWWWWWW
