40
30
5
WWWWWWWWWWWWWWWWWWWWWWWWWWWWWWWWWWWWWWWW
W      E WWWWWWWWWWWWWWWWWWWWWWWWWWWWWWW
W PPPP   WWWWWWWWWWWWWWWWWWWWWWWWWWWWWWW
W        WWWWWWWWWWWWWWWWWWWWWWWWWWWWWWW
W PPPPP  WWWWWWWWWWWWWWWWWWWWWWWWWWWWWWW
W        WWWWWWWWWWWWWWWWWWWWWWWWWWWWWWW
W PPPPP  WWWWWWWWWWWWWWWWWWWWWWWWWWWWWWW
WE       WWWWWWWWWWWWWWWWWWWWWWWWWWWWWWW
W PPPPP  WWWWWWWWWWWWWWWWWWWWWWWWWWWWWWW
W        WWWWWWWWWWWWWWWWWWWWWWWWWWWWWWW
W PPPPP  WWWWWWWWWWWWWWWWWWWWWWWWWWWWWWW
W        WWWWWWWWWWWWWWWWWWWWWWWWWWWWWWW
W PPPPP  WWWWWWWWWWWWWWWWWWWWWWWWWWWWWWW
W                 WWWWWWWWWWWWWWWWWWWWWW
W PPPPPPPPPPPPPP  WWWWWWWWWWWWWWWWWWWWWW
W E               WWWWWWWWWWWWWWWWWWWWWW
W PPPPPPPPPPPPPP  WWWWWWWWWWWWWWWWWWWWWW
W                 SWWWWWWWWWWWWWWWWWWWWW
W PPPPPPPPPPPPPP   WWWWWWWWWWWWWWWWWWWWW
W                 WWWWWWWWWWWWWWWWWWWWWW
W PPPPPPPPPPPPPP  WWWWWWWWWWWWWWWWWWWWWW
W                 WWWWWWWWWWWWWWWWWWWWWW
W PPPPPPPPPPPPPP  WWWWWWWWWWWWWWWWWWWWWW
W                 WWWWWWWWWWWWWWWWWWWWWW
WWE       E PPPP  WWWWWWWWWWWWWWWWWWWWWW
W                 WWWWWWWWWWWWWWWWWWWWWW
WWWWWWWWWWWWWWWWWWWWWWWWWWWWWWWWWWWWWWWW
WWWWWWWWWWWWWWWWWWWWWWWWWWWWWWWWWWWWWWWW
WWWWWWWWWWWWWWWWWWWWWWWWWWWWWWWWWWWWWWWW
WWWWWWWWWWWWWWWWWWWWWWWWWWWWWWWWWWWWWWWW
