40
30
WWWWWWWWWWWWWWWWWWWWWWWWWWWWWWWWWWWWWWWW
W   W  E              W       W        W
W   W P P P PW        W       W        W
W   W P P P PW        W       W        W
W   W P P P PW        W       W        W
W   W P P P PW        W       W        W
W   W P P P PW        W       W        W
W   W P P P PW        W       W        W
W   W P P P PW        W       W        W
W   W P P P PW                W        W
W   W P P P PW    E   W       W        W
W   W        W        W       W        W
W   W        W        W       W        W
WWWWWWW WWWWWWWWWWWWWWWWWWWWWWWWWWW WWWW
W                                      W
WS                             E       W
W                                      W
WWWWWW WWWW WWWWWWW WWWWW WWWW WWWWWW WW
W       W       W  E       W           W
W  P P PW  P P PW P P P P PW P P P P P W
W  P P PW  P P PW P P P P PW P P P P P W
W  P P PW  P P PW P P P P PW P P P P P W
W  P P PW  P P PW P P P P PW P P P P P W
W  P P PW  P P PW P P P P PW P P P P P W
W  P P PW  P P PW P P P P PW P P P P P W
W  P P PW  P P PW P P P P PW P P P P P W
W  P P PW  P P PW P P P P PW P P P P P W
W  P P PW  P P PW P P P P PW P P P P P W
W E                                    W
WWWWWWWWWWWWWWWWWWWWWWWWWWWWWWWWWWWWWWWW
